9	18	1	1	7	16
111111111111111111
101000010000000011
110111101111111101
111011111011000101
101101000000000101
110110110111001101
100001011111111011
110101100000000101
111111111111111111